name	effect
伤害	\data\特效\文字\伤害.eff
暴击	\data\特效\文字\暴击.eff
玩家伤害	\data\特效\文字\玩家伤害.eff
玩家暴击	\data\特效\文字\玩家暴击.eff
生命	\data\特效\文字\生命.eff
法力	\data\特效\文字\法力.eff
红心	\data\特效\文字\红心.eff
经验	\data\特效\文字\经验.eff
闪光01	\data\特效\战斗\闪光01.eff
闪光02	\data\特效\战斗\闪光02.eff
冒血01	\data\特效\战斗\冒血01.eff
冒血02	\data\特效\战斗\冒血02.eff
升级01	\data\特效\战斗\升级01.eff
滑铲01	\data\特效\战斗\滑铲01.eff
落地01	\data\特效\战斗\落地01.eff
后撤01	\data\特效\战斗\后撤01.eff
发光01	\data\特效\战斗\发光01.eff
角色升级	\data\特效\主角\角色升级.eff
大跳光柱	\data\特效\主角\大跳光柱.eff
水下冒泡	\data\特效\主角\水下冒泡.eff
阿鲁卡多剑芒	\data\特效\主角\阿鲁卡多剑芒.eff
阿鲁卡多死亡	\data\特效\主角\阿鲁卡多死亡.eff
里希特死亡	\data\特效\主角\里希特死亡.eff
玛丽亚死亡	\data\特效\主角\玛丽亚死亡.eff
玛丽亚火球	\data\特效\主角\玛丽亚火球.eff
玛丽亚火球斜下	\data\特效\主角\玛丽亚火球斜下.eff
地狱火	\data\特效\主角\地狱火.eff
飞刀	\data\特效\主角\飞刀.eff
飞斧	\data\特效\主角\飞斧.eff
反弹射线	\data\特效\主角\反弹射线.eff
圣水	\data\特效\主角\圣水.eff
圣水爆炸	\data\特效\主角\圣水爆炸.eff
圣盐	\data\特效\主角\圣盐.eff
圣盐落地	\data\特效\主角\圣盐落地.eff
圣经	\data\特效\主角\圣经.eff
怀表	\data\特效\主角\怀表.eff
闪电	\data\特效\主角\闪电.eff
十字架	\data\特效\主角\十字架.eff
十字架粒子	\data\特效\主角\十字架粒子.eff
飞剑	\data\特效\主角\飞剑.eff
生命上限	\data\特效\物品\生命上限.eff
法力上限	\data\特效\物品\法力上限.eff
红心上限	\data\特效\物品\红心上限.eff
魔导器	\data\特效\物品\魔导器.eff
打开宝箱	\data\特效\物品\打开宝箱.eff
蓝色染料	\data\特效\物品\蓝色染料.eff
绿色染料	\data\特效\物品\绿色染料.eff
红色染料	\data\特效\物品\红色染料.eff
黑色染料	\data\特效\物品\黑色染料.eff
黄色染料	\data\特效\物品\黄色染料.eff
紫色染料	\data\特效\物品\紫色染料.eff
恢复生命	\data\特效\物品\恢复生命.eff
恢复法力	\data\特效\物品\恢复法力.eff
恢复红心	\data\特效\物品\恢复红心.eff
火焰01	\data\特效\火焰\001.eff
火焰02	\data\特效\火焰\002.eff
火焰03	\data\特效\火焰\003.eff
爆炸01	\data\特效\爆炸\001.eff
爆炸02	\data\特效\爆炸\002.eff
爆炸03	\data\特效\爆炸\003.eff
爆炸04	\data\特效\爆炸\004.eff
爆炸05	\data\特效\爆炸\005.eff
爆炸06	\data\特效\爆炸\006.eff
爆炸07	\data\特效\爆炸\007.eff
骷髅统领飞镖	\data\特效\怪物\骷髅统领飞镖.eff
骷髅统领炸弹	\data\特效\怪物\骷髅统领炸弹.eff
骷髅炸弹爆炸	\data\特效\怪物\骷髅炸弹爆炸.eff
剪刀男剪刀	\data\特效\怪物\剪刀男剪刀.eff
骷髅猎人死亡	\data\特效\怪物\骷髅猎人死亡.eff
骷髅猎犬死亡	\data\特效\怪物\骷髅猎犬死亡.eff
奥洛克光波	\data\特效\怪物\奥洛克光波.eff
奥洛克骷髅	\data\特效\怪物\奥洛克骷髅.eff
奥洛克蝙蝠	\data\特效\怪物\奥洛克蝙蝠.eff
奥洛克地火	\data\特效\怪物\奥洛克地火.eff
奥洛克鬼火	\data\特效\怪物\奥洛克鬼火.eff
奥洛克死亡	\data\特效\怪物\奥洛克死亡.eff
双刃铠兵投剑	\data\特效\怪物\双刃铠兵投剑.eff
双刃铠兵死亡	\data\特效\怪物\双刃铠兵死亡.eff
战锤铠兵投锤	\data\特效\怪物\战锤铠兵投锤.eff
战锤铠兵死亡	\data\特效\怪物\战锤铠兵死亡.eff
统领之剑	\data\特效\怪物\统领之剑.eff
恶魔之剑	\data\特效\怪物\恶魔之剑.eff
剑魔武器	\data\特效\怪物\剑魔武器.eff
剑魔死亡	\data\特效\怪物\剑魔死亡.eff
僵尸骑兵死亡	\data\特效\怪物\僵尸骑兵死亡.eff
披风剑客轮廓	\data\特效\怪物\披风剑客轮廓.eff
披风剑客飞剑	\data\特效\怪物\披风剑客飞剑.eff
披风剑客死亡	\data\特效\怪物\披风剑客死亡.eff
人鱼火球1	\data\特效\怪物\人鱼火球1.eff
人鱼火球2	\data\特效\怪物\人鱼火球2.eff
人鱼爆炸	\data\特效\怪物\人鱼爆炸.eff
僵尸燃烧	\data\特效\怪物\僵尸燃烧.eff
座狼燃烧	\data\特效\怪物\座狼燃烧.eff
死士喷血	\data\特效\怪物\死士喷血.eff
死士爆炸	\data\特效\怪物\死士爆炸.eff
蓝僵尸死亡	\data\特效\怪物\蓝僵尸死亡.eff
蓝骷髅兵死亡	\data\特效\怪物\蓝骷髅兵死亡.eff
扔斧绿怪死亡	\data\特效\怪物\扔斧绿怪死亡.eff
扔骨骷髅死亡	\data\特效\怪物\扔骨骷髅死亡.eff
酸水骷髅死亡	\data\特效\怪物\酸水骷髅死亡.eff
骷髅剑士死亡	\data\特效\怪物\骷髅剑士死亡.eff
骷髅弓手死亡	\data\特效\怪物\骷髅弓手死亡.eff
骷髅枪手死亡	\data\特效\怪物\骷髅枪手死亡.eff
骷髅骑士死亡	\data\特效\怪物\骷髅骑士死亡.eff
骷髅头骨爆炸	\data\特效\怪物\骷髅头骨爆炸.eff
怨灵冒泡	\data\特效\怪物\怨灵冒泡.eff
怨灵冒泡绿	\data\特效\怪物\怨灵冒泡绿.eff
怨灵死亡	\data\特效\怪物\怨灵死亡.eff
妖草死亡	\data\特效\怪物\妖草死亡.eff
骷髅飞镖	\data\特效\怪物\骷髅飞镖.eff
飞镖骷髅死亡	\data\特效\怪物\飞镖骷髅死亡.eff
天使猎人死亡	\data\特效\怪物\天使猎人死亡.eff
木偶死亡	\data\特效\怪物\木偶死亡.eff
蝎狮死亡	\data\特效\怪物\蝎狮死亡.eff
鸭嘴怪火球	\data\特效\怪物\鸭嘴怪火球.eff
鸭嘴怪死亡	\data\特效\怪物\鸭嘴怪死亡.eff
飞飞魔死亡	\data\特效\怪物\飞飞魔死亡.eff
飞飞魔火球1	\data\特效\怪物\飞飞魔火球1.eff
飞飞魔火球2	\data\特效\怪物\飞飞魔火球2.eff
长臂魔火球1	\data\特效\怪物\长臂魔火球1.eff
长臂魔火球2	\data\特效\怪物\长臂魔火球2.eff
长臂魔刀光	\data\特效\怪物\长臂魔刀光.eff
长臂魔死亡	\data\特效\怪物\长臂魔死亡.eff
跳蚤男死亡	\data\特效\怪物\跳蚤男死亡.eff
跳蚤甲兵死亡	\data\特效\怪物\跳蚤甲兵死亡.eff
跳蚤飞鹰死亡	\data\特效\怪物\跳蚤飞鹰死亡.eff
鬼桌子物品	\data\特效\怪物\鬼桌子物品.eff
鬼桌子死亡	\data\特效\怪物\鬼桌子死亡.eff
旋镖骷髅死亡	\data\特效\怪物\旋镖骷髅死亡.eff
装甲骑士死亡	\data\特效\怪物\装甲骑士死亡.eff
锤头骑士死亡	\data\特效\怪物\锤头骑士死亡.eff
树妖攻击	\data\特效\怪物\树妖攻击.eff
树妖死亡	\data\特效\怪物\树妖死亡.eff
花妖死亡	\data\特效\怪物\花妖死亡.eff
鸟人死亡	\data\特效\怪物\鸟人死亡.eff
泥人死亡	\data\特效\怪物\泥人死亡.eff
猫头鹰死亡	\data\特效\怪物\猫头鹰死亡.eff
猫头鹰骑士死亡	\data\特效\怪物\猫头鹰骑士死亡.eff
重剑骑士剑气	\data\特效\怪物\重剑骑士剑气.eff
重剑骑士死亡	\data\特效\怪物\重剑骑士死亡.eff
楼梯守卫死亡	\data\特效\怪物\楼梯守卫死亡.eff
小恶魔死亡	\data\特效\怪物\小恶魔死亡.eff
小恶魔聚气	\data\特效\怪物\小恶魔聚气.eff
小恶魔召唤	\data\特效\怪物\小恶魔召唤.eff
狮鹫怪聚气	\data\特效\怪物\狮鹫怪聚气.eff
狮鹫怪吐火	\data\特效\怪物\狮鹫怪吐火.eff
狮鹫怪掉毛	\data\特效\怪物\狮鹫怪掉毛.eff
狮鹫怪死亡	\data\特效\怪物\狮鹫怪死亡.eff
飞行骷髅死亡	\data\特效\怪物\飞行骷髅死亡.eff
长枪骷髅死亡	\data\特效\怪物\长枪骷髅死亡.eff
黑乌鸦死亡	\data\特效\怪物\黑乌鸦死亡.eff
流星骷髅死亡	\data\特效\怪物\流星骷髅死亡.eff
双刀骷髅死亡	\data\特效\怪物\双刀骷髅死亡.eff
骷髅刀客死亡	\data\特效\怪物\骷髅刀客死亡.eff
骷髅刀客落地	\data\特效\怪物\骷髅刀客落地.eff
骷髅刀客滑铲	\data\特效\怪物\骷髅刀客滑铲.eff
骷髅巨人骨头	\data\特效\怪物\骷髅巨人骨头.eff
骷髅巨人死亡	\data\特效\怪物\骷髅巨人死亡.eff
长枪守卫死亡	\data\特效\怪物\长枪守卫死亡.eff
巨剑铠兵死亡	\data\特效\怪物\巨剑铠兵死亡.eff
骷髅恶灵死亡	\data\特效\怪物\骷髅恶灵死亡.eff
半人鸟死亡	\data\特效\怪物\半人鸟死亡.eff
半人鸟飞刀	\data\特效\怪物\半人鸟飞刀.eff
半人鸟火球	\data\特效\怪物\半人鸟火球.eff
骷髅旋镖	\data\特效\怪物\骷髅旋镖.eff
骷髅射箭	\data\特效\怪物\骷髅射箭.eff
骷髅子弹	\data\特效\怪物\骷髅子弹.eff
骷髅骨头	\data\特效\怪物\骷髅骨头.eff
妖草口水	\data\特效\怪物\妖草口水.eff
妖草口水落地	\data\特效\怪物\妖草口水落地.eff
影子飞刀	\data\特效\怪物\影子飞刀.eff
影子飞斧	\data\特效\怪物\影子飞斧.eff
影子死亡	\data\特效\怪物\影子死亡.eff
小恶魔火球	\data\特效\怪物\小恶魔火球.eff
小恶魔绿火	\data\特效\怪物\小恶魔绿火.eff
小恶魔绿火爆炸	\data\特效\怪物\小恶魔绿火爆炸.eff
怪物飞斧	\data\特效\怪物\怪物飞斧.eff
怪物飞斧上	\data\特效\怪物\怪物飞斧上.eff
怪物飞斧下	\data\特效\怪物\怪物飞斧下.eff
魔化圣经	\data\特效\怪物\魔化圣经.eff
魔化圣盐	\data\特效\怪物\魔化圣盐.eff
魔化圣水	\data\特效\怪物\魔化圣水.eff
魔化圣盐落地	\data\特效\怪物\魔化圣盐落地.eff
魔化圣水爆炸	\data\特效\怪物\魔化圣水爆炸.eff
羽恶魔掉毛	\data\特效\怪物\羽恶魔掉毛.eff
羽恶魔羽毛	\data\特效\怪物\羽恶魔羽毛.eff
羽恶魔乌鸦	\data\特效\怪物\羽恶魔乌鸦.eff
羽恶魔泡泡	\data\特效\怪物\羽恶魔泡泡.eff
羽恶魔聚气	\data\特效\怪物\羽恶魔聚气.eff
羽恶魔死亡	\data\特效\怪物\羽恶魔死亡.eff
羽恶魔燃烧	\data\特效\怪物\羽恶魔燃烧.eff
狼人火球	\data\特效\怪物\狼人火球.eff
狼人火墙	\data\特效\怪物\狼人火墙.eff
狼人死亡	\data\特效\怪物\狼人死亡.eff
牛头人扔斧	\data\特效\怪物\牛头人扔斧.eff
牛头人扔砖	\data\特效\怪物\牛头人扔砖.eff
牛头人吹气	\data\特效\怪物\牛头人吹气.eff
牛头人死亡	\data\特效\怪物\牛头人死亡.eff
青蛙死亡	\data\特效\怪物\青蛙死亡.eff
冰晶女攻击	\data\特效\怪物\冰晶女攻击.eff
冰晶女死亡	\data\特效\怪物\冰晶女死亡.eff
食人鱼攻击	\data\特效\怪物\食人鱼攻击.eff
食人鱼死亡	\data\特效\怪物\食人鱼死亡.eff
骷髅鱼头火球	\data\特效\怪物\骷髅鱼头火球.eff
骷髅鱼头吐火	\data\特效\怪物\骷髅鱼头吐火.eff
骷髅鱼头死亡	\data\特效\怪物\骷髅鱼头死亡.eff
魅魔射箭	\data\特效\怪物\魅魔射箭.eff
魅魔飞花	\data\特效\怪物\魅魔飞花.eff
魅魔泡泡	\data\特效\怪物\魅魔泡泡.eff
魅魔受伤	\data\特效\怪物\魅魔受伤.eff
魅魔死亡	\data\特效\怪物\魅魔死亡.eff
海妖水泡升起	\data\特效\怪物\海妖水泡升起.eff
海妖水泡攻击	\data\特效\怪物\海妖水泡攻击.eff
海妖水球聚气	\data\特效\怪物\海妖水球聚气.eff
海妖水球攻击	\data\特效\怪物\海妖水球攻击.eff
海妖水球爆炸	\data\特效\怪物\海妖水球爆炸.eff
海妖落石攻击	\data\特效\怪物\海妖落石攻击.eff
海妖狗头攻击	\data\特效\怪物\海妖狗头攻击.eff
海妖狼头攻击	\data\特效\怪物\海妖狼头攻击.eff
海妖死亡	\data\特效\怪物\海妖死亡.eff
地板破坏01	\data\特效\场景\地板破坏01.eff
地板破裂01	\data\特效\场景\地板破裂01.eff
墙壁破坏01	\data\特效\场景\墙壁破坏01.eff
墙壁破坏02	\data\特效\场景\墙壁破坏02.eff
墙壁破裂01	\data\特效\场景\墙壁破裂01.eff
墙壁破裂02	\data\特效\场景\墙壁破裂02.eff
墙壁破裂03	\data\特效\场景\墙壁破裂03.eff
墙壁破裂04	\data\特效\场景\墙壁破裂04.eff
墙壁破裂05	\data\特效\场景\墙壁破裂05.eff
墙壁破裂06	\data\特效\场景\墙壁破裂06.eff
台阶破裂01	\data\特效\场景\台阶破裂01.eff
大门破裂01	\data\特效\场景\大门破裂01.eff
炮弹01	\data\特效\场景\炮弹01.eff
传送01	\data\特效\场景\传送01.eff
灯火01	\data\特效\场景\灯火01.eff
灯火02	\data\特效\场景\灯火02.eff
灯台01	\data\特效\场景\灯台01.eff
灯台02	\data\特效\场景\灯台02.eff
灯台03	\data\特效\场景\灯台03.eff
灯台04	\data\特效\场景\灯台04.eff
灯台05	\data\特效\场景\灯台05.eff
灯台06	\data\特效\场景\灯台06.eff
桌子01	\data\特效\场景\桌子01.eff
桌子02	\data\特效\场景\桌子02.eff
凳子01	\data\特效\场景\凳子01.eff
凳子02	\data\特效\场景\凳子02.eff
水花01	\data\特效\场景\水花01.eff
水花02	\data\特效\场景\水花02.eff
水花03	\data\特效\场景\水花03.eff
瀑布水花01	\data\特效\场景\瀑布水花01.eff
瀑布水花02	\data\特效\场景\瀑布水花02.eff
瀑布水花03	\data\特效\场景\瀑布水花03.eff
飞镖	\data\特效\投掷\飞镖.eff
十字镖	\data\特效\投掷\十字镖.eff
火焰镖	\data\特效\投掷\火焰镖.eff
火焰镖粒子	\data\特效\投掷\火焰镖粒子.eff
梅花镖	\data\特效\投掷\梅花镖.eff
柳生镖	\data\特效\投掷\柳生镖.eff
回旋镖	\data\特效\投掷\回旋镖.eff
烈焰回旋镖	\data\特效\投掷\烈焰回旋镖.eff
村正飞刀	\data\特效\投掷\村正飞刀.eff
铁球	\data\特效\投掷\铁球.eff
无双飞轮	\data\特效\投掷\无双飞轮.eff
中子炸弹	\data\特效\投掷\中子炸弹.eff
TNT炸药	\data\特效\投掷\TNT炸药.eff
烈性炸药	\data\特效\投掷\烈性炸药.eff
业力之币	\data\特效\投掷\业力之币.eff
毁灭之剑	\data\特效\投掷\毁灭之剑.eff
天堂之剑	\data\特效\投掷\天堂之剑.eff
魔法之箭	\data\特效\投掷\魔法之箭.eff
魔法徽章	\data\特效\投掷\魔法徽章.eff
蝙蝠徽章	\data\特效\投掷\蝙蝠徽章.eff
父亲大人	\data\特效\投掷\父亲大人.eff
